20
50
PPPPPPPPPPPPPPPPPPPPPPPPPPPPPPPPPPPPPPPPPPPPPPPPPP
PPPPPPPPPPPPPPPPPPPPPPPPPPPPPPPPPPPPPPPPPPPPPPPPPP
PEPEEEEEEEEEEEPEEEEEEEEEPEEEEEEEPEPEEEEEEEEEPEEEPP
PEPEPPPPPPPEPEPEPPPPPPPPPEPEPPPEPEPEPEPPPPPEPPPEPP
PEPEEEPEEEPEPEEEPEEEEEEEEEPEEEPEPEEEPEPEEEPEEEEEPP
PEPPPEPPPEPEPPPPPEPPPPPPPPPPPEPEPEPPPEPEPEPPPPPEPP
PEPEEEPEEEPEEEEEEEPEEEPEEEEEPEPEPEEEPEPEPEEEPEEEPP
PEPEPPPEPEPPPPPPPPPEPEPEPPPEPEPEPPPPPEPEPPPEPPPPPP
PEEEPEEEPEEEEEEEPEEEPEPEPEPEEEPEPEEEEEPEPEPEEEEEPP
PEPPPPPEPPPPPPPEPEPEPEPEPEPPPPPEPEPPPEPEPEPPPPPEPP
PEPEEEEEPEEEPEEEPEPEPEPEPEEEEEEEEEPEEEPEPEEEPEEEPP
PEPEPPPPPEPEPEPPPEPEPEPEPPPPPEPPPPPEPPPEPEPPPEPEPP
PEPEPEPEEEPEEEPEPEPEPEPEEEEEPEPEEEPEPEEEPEEEPEPEPP
PEPEPEPEPPPPPPPEPEPEPEPPPPPEPPPEPEPEPEPPPEPEPEPEPP
PEPEPEPEPEEEEEPEEEPEPEEEPEPEEEEEPEPEPEEEPEPEPEPEPP
PEPEPEPEPEPEPEPPPPPEPPPEPEPPPPPPPEPEPPPEPPPEPEPPPP
PEEEPEEEPEPEPEEEEEEEPEEEPEEEEEEEPEPEEEPEPEEEPEEEPP
PPPPPEPPPPPEPPPPPPPPPEPPPPPEPPPEPEPPPPPEPEPEPPPEPP
PEEEEEEEEEEEPEEEEEEEEEEEEEEEPEEEPEEEEEEEEEPEEEPEEE
PPPPPPPPPPPPPPPPPPPPPPPPPPPPPPPPPPPPPPPPPPPPPPPPPP
